111111111111111111111111111111111111111111
11P00C00000000C000010000000000000000000011
111110000CC0000000010000000000000000000011
1100000E00C0000000000000000000000000000011
110000000000C00000010000000000000000000011
110000000000C00000010000000000000000000011
110000000000C00000010000000000000000000011
110000000000C00000010000000000000000000011
110000000000C00000010000000000000000000011
110000000000C00000010000000000000000000011
110000000000C00000010000000000000000000011
110000000000C00000010000000000000000000011
110000000000C00000010000000000000000000011
110000000000C00000010000000000000000000011
110000000000C00000010000000000000000000011
110000000000C00000010000000000000000000011
110000000000C00000010000000000000000000011
110000000000C00000010000000000000000000011
110000000000C00000010000000000000000000011
110000000000C00000010000000000000000000011
110000000000C00000010000000000000000000011
111111111111111111111111111111111111111111
